ssr: mkc zdr
ccn: hpf drf dnr
bpf: krh stt
lhf: zpv
pgn: xjc
gfn: xhp hvg bqd
srl: hfb gmm qjh
mtb: mcl nps
hkc: dcz mcl kzp zpc sgg
fhd: vst
kpz: shk mfn
qkb: gdx
dgb: xvb mnf
cnt: pfj khj qdb
rxk: ktd
xtf: dhk mqk zmp
czq: hpc tmk ttv gmk
rcs: scs
zjt: jgd jcm kms
vdj: jkt ssd
zpq: lmx tcv zdl
mpz: jcb hfl ppj
bcm: ctd dtz ssd dxd lsl
qqq: cjl pdp zhv tvb
gxj: lkj tbq sfm
zhk: fqf ptj vln
zdl: lxk dpr tcv
ncp: vqp vqn
srz: lnv fsg
jqk: csq mcz
cvv: glq rsc dzf gdn dfp
vcx: vdj npc nrx
lbq: zds
psn: npq xzz gjx svf
tnf: zqk jhs zbh lnq
vtz: bhh gxr blx
pzq: vcj cqn jxr qvx
bdt: jzm dhh hpc tbp
gjm: vtz kjl jln
zcg: kcv sqv
fck: qsp tcp
lls: zvq tkd tzd
hbr: hld rkl cbg
zsh: dcx zhr
mmr: tbk qns zmp
fvf: rsp
rfr: bdd
krn: dkk dfd
vvc: hmj zmh
ctd: gmg lmq zzk
sqk: qsg hpq nhf
rsp: vlb
tsf: dkp csh
lcm: tjj
nxn: gph kjl
jxr: rgn
cch: snz
dtz: kng
gkn: bgm
rfk: ngv
qrr: bqr rjp fqs gsx rjr
dmq: clv zdj zmh
dxd: mxp
gxr: nnh hpn
pqx: nbh qjx frt vpb mmn
mdt: qkc jzn jks qbc zdp
frj: fgj
dvv: tjj hkm tqf cmc
mcs: ttz xcr
vxg: mcp gxt mqn
pmv: sqv
mzb: zsh
pvf: sgg jzx
sxk: nsg mpc qjh
grj: srz dgx
vbh: sbn rkl
qzg: xdv zgb mpl fmc
zbl: zbf
nst: svd
fbq: cmf dcx gzt lln
kfb: gsk
lsv: lch lxt mfv lxk
slc: ppg
rds: hrd tlv qbm
vgp: qcp tcj
kcx: mbc gkn xmk xtj
kzj: fpg dng
qhr: gfm ktx lmg kbn
dtr: fgc mzg mcs
vfx: mfh frd
szm: hkt gmm hfh ckk
qdg: rcg
kxg: qnz vbk pff hll dfs
hgm: gnk ptd mxc kmb
gbx: mkt nkn mcj
fpx: dtz zvh
lgl: qcg zbh rcg
sfv: mzg xfd kgs
sls: dfj tfd vtj znv
msc: gqz hdp gdn qbd
tfz: fnk scr vff tdb
gmb: gst dqr grk hfp
grs: pfj
xsr: bbs
vbj: pts lnm jzx
qnx: qxz ckk
nvt: dhc
dhk: ztd
zfm: shk npq kbn lbd
jjl: sht cvl qkr kbf
jsv: dhg jvg ghd hqs mrr
nlk: xsp cbt qmd
blx: mtb fhf
slk: bmb jjp hdg dtf
pkk: ksl
bjv: kbl rbl bdt fvf
njb: zlq
skz: tpn cxr vfx klc tpl
mmp: mhx mpc
xsm: hmj
xfd: xpz
vff: gmx zxl
pck: czg hjg jkt dkp
ldl: rsq gmm tkt
zfk: lpm qch fts
ctn: rxc svf
mnj: dlg jkt
fjj: rfb jhc rdb bmg
cqp: vxq ppx svd
pqj: pxc ggj qrz pdc
dqr: dnr rkl
qfn: zbf
fxr: xnh ljb nmb
chb: ztf hxp
lbb: cpv zqk hvg cvl
tjk: tts dhp
sfx: ktx znk gpz qln ggh
jjp: fhl zdg
xxn: mjv
dfv: xvh mfn hfb hzn
ths: vfl frz lhm nks sxx
cgs: lkj
zqd: tmk hgh hld dhs
fgg: kmr mhx xlt
jbh: dmg qkx bmg skl zlq
kkf: kql
thd: xnc pts jbf
pzb: zhk bln qpl bfs mgh
gfx: qjd bvk fmx ssv
hpf: xgq
csz: lmf rkk zrj
dmb: hbk zbn hhs
lbd: zvc
lnq: lxq nms lfp
dkh: svf mct kmj tjr
gxs: hcv ncp msj lxr lzx
snx: xzv
vkj: qmv krc tvx
mfv: mfh
svh: msn sxj stn
ltd: csq bmk cnt vkj mmp
cft: mhx vfn dpz bdl krn
gld: mkj rkd dsr hsx dzj
sfg: pmx dtc vst
xqq: dbx sxj
tgx: sfm kvt
cqv: lkz sxm
fnk: hls prg
knn: rvq cxl cfz
trp: rzn gnq xpp sjh
xtx: xpp
qbd: mmb
nnh: pms
clk: fxg mlk fxh nzh cbg
kqz: rnh ssd
glp: kkx nkp zbh fbq hmz vns
nxl: mxv zmt xgm
fhp: mzd jlk jtc
jzc: mfh lkp tnf ldr
lhm: vgp ptf
glr: mkt kjx zmm
xkh: cfk rjp jzx
ssv: gzp
fhl: rsp
tlx: fmc tgd zxk
ptd: krh fnr czp
bvx: fqf spp lsl nfx
jbm: qld vcj qmq pkl
trn: gcf qsj bgt
vjd: rfr dsx cms
mzt: pxs vqd sqf drx
rsv: zbf ddf tlx fnb
rpn: rsr lpq
pbg: mmb rlf
qrl: nhf fvf
qgp: jjb kll fhn qvx tjr
lnd: jtj
btp: rcj lfp
jcr: jgj
qmv: qbs zpc
blb: fst rzn rhs njr
gqj: cqv zvf qcb zkh
hxr: jbz
fts: mcs nnh
pvr: gsm rsq
skq: vqp bjs tch
ksf: dnq jxv nmv
qdk: nmb
qxv: dfv qdk rlj gzp zbz
nsk: gqz
zbb: knd hvp lls fhr njr htv
vqp: vst
cdr: fhv vvq zjq gsc
lbg: sns vzt sdz thd pxl
vbd: dhc rcn kfb bvq hlx png ghh
vrh: zrk
cvl: dnd
qhf: crj bhx
kqr: pgl kqp xld ccn
bvq: jcb
cxl: ljb
tss: xlm rht shh vrk
scv: glr qsr rjh cml
ksl: zpn bcz
zsz: kgp mmn xbm
pxs: rsp
hsj: kbf pvs lcf
jcb: mzg
hmt: fmv fzs tcp xkh
ktv: vsn nbk kvt
htr: sml hln lqs
jmc: nvg prg njb czg
mmt: svf gpz hgh dzq
nbh: stn zhr
rnk: pbf zlg
dzk: ltj ndh dfd xnh
dzl: smk xhp qzz xhm bln
nzt: lpq bnr bvq rpr
hdp: fhd tqn cgs gjp
mvs: mvr hnh rxc xgq
rbg: xrs gph jqk hqv czm
gmk: vhr pxl
sxm: tzz xlm
nbl: bbs kxn vvc psl
gjp: jcr
cfk: rbl
lss: nsl
gjj: mfv ffq
mrf: pbq tqn ptj lmq
lxr: dsx qss
hnz: pdc dtz rcb
vnz: qdg dcq hqd
mbs: tpl pck pmb jxg gqp
sbt: fmv cxm mmq
cxr: bgt
lgd: zxl ptp tpp tmb
rzg: ncm gmh tqb
ntv: dlx qjx trn lmq
ndh: hzj hfb
kzt: grs fqm
vln: tcj
kcv: cnb qkb
rpd: ghd dhh
vmd: gjj
jgv: sqv vxb
ttv: mrr
frz: zlq pdc
hmx: zns chf ftt
cxt: xcb hqq btp nbh
dlq: zdz zfk rsv
jzj: jxv bvq gsm gfm
skg: tkq tjj
hlj: hfl ptm
zbr: fvf kgs rkl
dht: pmz dgl
trd: nhf
gpt: phq vgp vjd frj lpl
qmk: fmc hfk kcb lbd
xmk: fgj
nzb: tpj nzh qcj
npc: tth mfd rnh
pjr: srz xsm
cnd: ctz gps bpf dgl
pmh: pkv lgl xhm vcg xmk
tbp: zdp gxn hlx
kkr: vpx hll
nvl: lvt knm gmh hll vbh
msl: rnp kzk zbz
cpv: tbq bnl
tch: gqp mfv pjf lmv djs
hkm: knc
bhh: khl mrr
jqb: zmh lkp fpx vdj
bxp: fsg xnq dst
hfh: bkz rxg pzl
vxj: hkf rsv cqg jvg
lpl: sht zxj tdb
jcj: cfl nds
hln: xjv lzg
hnh: kmb tcc
mbm: lbj ffq xmz sxj
zjf: dhh pxs kbr sdz qmr
rsx: sxk zmm
lbn: nmv qrl bvq msl sxz csq
mcl: smg
nmv: pgn
hdl: phn lbq bdl fgg
jks: kzp pcf
krh: pgl
rck: zhr xjv hlv
gpr: njt rpz lxs hrd
ftt: mjv
vqt: mcl lvk
hsx: zxj rzl
pdg: prp fqs qmr bjp rlx
hzs: kqp pmz rjb
fgn: rpr lnz hvz hzj
zkf: ccd
gzt: ssr sfg
hvg: sff qdl
zrq: lfs lns vpb lzl
dnh: dtc
jzr: njb hmx zfv zvm
bpx: dfd mvr dnq
njx: zqk kmq kfv jcr
mhq: tbk qkb xbt rsg
zhl: vvq xbm sxx dhj nms
cnx: rdb ktv
mpv: prk jfl sbn mcz
qkx: bcz htv rlz
ftk: nbh znv hvm gdv
phn: xtz zjf
kpc: clp xsm gdx
njr: kjs
jkg: mlk lvt kbn fmf
frc: ckc kns fhs rfn cng
cxc: nhf zjt fqm klt
plb: rdb
cvr: djn zmr zkf
hkt: xvn gsx
zjq: ngx xsk zdr lnv
smg: hpn
hlx: blx cml qnx kns
scr: qph nsn jcj
hbp: gnp zvp zpc gps
pdb: krc tmn krh
kcz: dtx xvb kqz ptf
jvg: zvc
nkn: krh mmp
qmd: ktd stm fhf tcp
zxk: sns tvt
qrq: svd scs
bvk: zdp gkt ppj
khl: hkf
str: kmd shg tth
pzh: hpn vqr kqk xcr
dmg: bqf mkf
lvt: vrh khl
bkt: pxl sgg kzp
cmv: dlg lcm lxk
sbx: ldl hvq hpf
kmr: pgn
krc: mmq
ndc: kpg mlg flj tgd
djq: xls jnf gjx rlj vgg
npn: zdr dhk kqz dhp
plp: gjp pjr fbr lzx
gsf: sdg qcb glq mgh
vlb: rjb
qss: zbn mmg kvn
clf: zht qsj
rdq: kmd pkk krv
tlv: xzv grs vbh
pkc: kxn sxj vkp psm mfd
nrf: prk tmn bhh
zlf: lhf gjm dzq hdb
qbs: dkk hgh hvz
dvz: plb fnk tvz vvc
tsh: gjj
cbt: hkf dkk
dhn: xvh
lpz: sff nst
zrv: qcl xvs lpq lnz
nzj: bxp nkp qsj
hsf: lhb xld jtj hlk pms gpz
hpc: jxv
ckk: xtz
fmm: hsg lhm mjv cdq jcj rbj
rxg: nhs
clh: cgq
rxl: rck kbf pmv
hqd: sff kxn
frd: gmg xsk
vfn: pgn hkf xjc
dxq: kjx kqr zhc hnd
bfr: mqn qrn
gdv: rkk fhd jfp qhf
vfc: nvt bhb xvh drf
qfl: lhb kns
dnp: vff nsk
txv: fnq vjh
jxg: ptj rkd fgb
pmk: zht tbr ltq
jhs: dlg clf dnh
mct: fzs clh xnc prp
ldq: mvh sqf djf xfn
vgb: vxb
czm: mlg
zzk: cxn nfn
hdb: qmv lhf
gzj: ndc blh pvr gsn
pbf: ltj pgn
zvq: jgh
cbb: qmk kzt zdg pgd kpz dbn
fmd: gmz pqp ngz mcj
lgp: fhf chn qcj qsp
xqf: mqn fnb
sjh: mkc cxt
sns: hvz
zth: dhp csz psm
hqs: kpg zrk
lnr: tcz cml pxl
pkl: rnk pts
qzz: bdx
rcj: lbj cnb
lmq: slc qxm tfv
xmm: bvq bfr hpd
flc: rqh tmk xjm xng kpg xxf zdg
hkr: xbm
xcn: pvr clb hzc nzh tcc pgc
qsr: tqj sns
dzf: ssd qft
vmg: kql tdb tfz
hrq: lvk
dqs: tkd tgx hnz
mvr: dnr
hxx: qjk mvr rxc vjl
pfl: crc ppg
xrp: fgj lmv
tpj: rtz zsd qsg
skl: vrk
xgr: nnh
mfz: qzz pkk dhn gnq
vjl: fxh rhp mcj
flh: clh pff xld
xgs: bvs
hfk: srl klp cch
hrv: sbn zbl
jpm: fjq tbq fbv
sds: bmg zcg blk pfr
jkt: ccd
mcz: jcb xhn
tqb: hrq pjb
hss: rmf rzs ctz
rsq: ttv
kbx: ngv xqf zds prk
hhv: str dpr hqq ltn zsj
nzh: mzg
fnr: gnp nxm
tcc: kbx tgd
mmd: xdj hgr cks tfv
ljh: trd kxp chn nxm
gfk: xvn vxn jcb sdr
tvt: cgq fxr ngv
vpx: tvb
vkl: xdv qsg lnm jjb
jxb: hmj bst cxr cvl
spk: rcg jsk tzd cxn
qhn: cvl
ptp: phq dgx
zht: kql xrd qvb
rvv: lhg zmr hsx
dbp: kll tcp svq
bkl: mjh hkm rsc vrk
mbc: pns fsz prg cqv xcx
nfd: tgd lxn
zdz: cqn
znv: kvj kmq xmz zrj
mlp: vfx cvr qzs mjh
bdl: kjx ktx tzg
lzr: ztv dfj nrx cxt
ptj: qmr
bqr: qlc zbz
djf: hfp rlx pfj
hnd: npf
gxh: dfc nhs fnr cls dkk
tsv: vcn fhf jbf
rpt: hdb nmb dfz dlq
mzd: srz gmx pmk
mkt: rmf bkt
fmf: ndh pdv cng
gst: tqj qlk prb
ggh: qkc sbx hxv
gsx: xnc cgq
xsb: dlx dfp zgg
fhr: vns kng tgx
dbs: vld knn pms nsl
lxn: kmn
lbh: zdr nrq
qld: jzm hzs fqz jlx
xtz: pdv
rsh: kpz qdd tmk pgn
zsv: jgv gzt nxl lmv
ctz: khl hfp nsm
khz: gps
kpr: pvs nxp xxv psm
tvf: pvf crl mxc
mfn: vbn qfn
dfp: knc
rcb: lxb
vtc: pkv kdd tkc djm
zlx: rmn kcv pck jrz
mgq: zcg vqp rzl nxp
rhp: drc dgl
gkx: vxq knc gqp
xnl: zsd dnl gsm
tng: gmx jrz lpl tqn
hlk: prk
dfs: fmp pcf
sxp: qcp dgb ftt
szv: ncm kxg kvf
pdj: sdr rcp xtz mlg prp
hlt: zhr
blk: fsz
bhd: jgv
fbr: qsj
tfv: djm cms
fqm: kzp
qzn: jvl lmq rfb
rdx: zvh jgj lpj vkv
rdb: hkr
jmj: pms phn nrf pcf zbf
kzq: sxm hlt xnq glq
qfv: mtv chf chb fhc
qcg: ngx hmx
pdq: bmq nnq cxl dlf
pns: lxb jrz mxp
rbz: bgm gxj pxc hxr
bhx: xqq cnx lzg
dpr: dnd qvb
pks: mnh lgp pzl mvh xgr
xvh: gfm dhg rxk hzn
fqf: dfk
jsk: xdb kbf ngx
mxv: svp xbt dtx
zss: bcz msn xlm blk nsn
mkj: dsx cvl
gsc: pmv
hcr: msj tth jfc chk
knm: nvt hpd gmh
prb: kbq krn gsn vbn
hzc: tcp pmz xjm
cbp: rnk krh zvc jtj
rlz: qrz fjq
hqv: fkn ttz sns
lbr: lfp zjl
zgj: lbj fhc sxq nsk xxn
fqs: jql nxm lnz
tkq: mmg
tpn: tkq xrd kqz
hsn: hmj
jgt: btp xnq xcs cmc
qkr: cvq dtx
tmb: lrm vln fsz xbz
tdp: lcb sbd tzt hvg
hgn: hrv xnl rsq
vxn: bkz qmv
flj: czp gsn
cvq: xgs jgj
qgs: gkn lvh tgx vrr
brk: dnl vmn jzx rpn
lrj: klt kdk kpg czp
tcz: xgq kmr
zcm: gck pgc cls mfn
hdg: blh
cmf: fnx
plc: tzj gdr mkr rzg
pdz: djn hln xgm
khj: cch
cqm: hll flh blx rmf
hbx: hqq rht zqk
ltq: nsn pvs cdq
zmt: zsj
svp: zdj kkf
mxp: jfc
xps: mcp zpc xnc
vnt: hkt lpq vqt
tvl: nhf khz gph qbs
rvq: vjh shk
bmk: nmb hxv xnh
mbp: dtf jks qlk fts nzb
zcp: mdt rjb rhp gnk
jfc: rcb
nfv: glq kng gkn
qmq: drx stm
kjz: bdd tbq fgb ppg
cmc: dcq nfn
krd: rcs htr pdz lhg
tzt: tts lkp
lhb: lpm
csh: pjr hsn mxv
kdk: cqg sdr
clb: hqs kbl pkl
jrz: vqn cms
srv: rzg knm
nhv: lzg kmq fqf bhx
sbd: cps zpq
fhc: qdl
drf: zbz
gbr: qxm ngx lsl
gqx: hld bmb czm
mhk: rdb xgs ltq
hmn: jhc kcv bfs xxv hxp
rlx: sqf kzk zlg
kdd: kng knc
szg: cml smg
ljm: kzs rcg rfr dng
gcf: xxv
xvs: xtz ngv qrn rvq
kmq: mzq
zbh: sfg vcq
jnf: dht flj
qbc: rfk klt
jtg: vcn qsg mpl dkk
mmn: ztd
shg: lnv kfq
cks: cqp mgh hbk
lln: qhs rcb
kzs: nkp
xrk: dtx nks
dbq: hxp xcx tjj
jlx: jbf cch ttz
znh: hgg rjh xng dkr
kmj: fnq rjb blh
pfr: ggb
qcs: fpv mqk
gdn: rkk
zmk: vch lmv nqh ztv
xdj: knc
vmb: rxc zdz fnq fqm
gzp: znk
gql: sjh chb
rqz: tzt vnz bvv qft
rsb: frd zmt jjj
qvx: sxz jtg
rql: tgx kkf
tzg: nsm mtt hkc
mlk: mrr xzz
mgm: qsr kqk khz lmg
chf: xrk tjj clv
khs: bjp
jzn: fxr
hbk: nrq
bhb: jtj svf
lfs: dhp xvq
gnc: qjb cgs nhm vbp gsc
jnm: nfz khj tcz jbn
pgd: dfs
sps: nqh vnd chk npn
jgd: fhs txv
bkz: hfb cbg kzt
xzs: tfv lkj snf
qxh: rmn dhn dgx
njt: kmn bhb
jln: qsr fck rvq
rlj: lpq
pjf: qhn
qqc: qrl ldg qch
xcb: jkt lpz
hpn: bjp
lkk: rdb kfq gcf ztv
ngv: pjb
dpz: vxn fmf grs
zdx: hdg rsr pgc
gbc: fxg svq nfd xgr
hvj: nvb tdn xcs qkr
vqd: mmq drx xsp xcr
jsj: lmq spp mqk
bhz: bnr rbl pjb jks
gpg: fkd nfn cdq crc
hzj: svf flh
vpb: vqn tcv kgp tcj
ddg: qcp xjv dmg zjl
mnf: dsx
lnz: xcr
kng: xbm
ckc: svg rnp
ktg: tqb tvf qqc bqr
qcj: hpd
ffq: jgh bqf
pnf: mnh vhr pdv hkf ngb xls
tzz: nxp
czg: pmx dsr
rcf: jvg zhv
rnz: cht tfm rxc zzz
jbn: hzq bmb
vbp: xdj
hbd: dtf jvg pfj lbq
qkl: lbq pzs ctn dnr
dch: svp knc tdp mhk
flq: bvs qhf hcv qph
fjq: bhd
svd: nds
ppx: ztf kjs pfl xbm
dsd: kkr rzs pmz ldq xqf
nml: flq pbt rgt
blh: smg
rbj: xcs zzt
nfz: lhf gbh
lmv: clv
fxg: sdr pvf
pvs: mnf vrk
zvf: mzb ksl dlx spp
xrl: ldr zvh dgx zjl
frp: nds
zrj: vpf
fnj: dhn gmg dmb
krv: fjq zpn kvn
xfb: kfq lxb tzd rbj qhn
clp: rql dfk xtj
qkc: dnq ngz hkt ndh tzj gfm
jlk: zjp gtj zgg vnd
fkd: qkb frd zgg
zlg: xzv kgs
tbr: djn
pcz: hzn dbp czm kfb
rlf: vst prg
xjx: tpp lxr hsn
xhj: zjl xsb dvz kqz xrt
zgb: bhb
mjh: nhm jgj
ljl: qrl cxm prp
qch: lxn rjb
gdp: sml pjr nhm dhj
mzq: zbn pbg vcx kvj
lsl: bqf
bnl: kql pbt
hks: zdp ldg rlx gmm
chn: cbn vhr
tkt: vbk zrk qtx
sqt: cxm kjx nsl cqg dtr
bbs: lzx sxx
tfm: xng blh pdb
hvm: cks jgh cfl
qlk: mqn kld
shk: pgl
hvq: kdk gmm rzs
tfd: dbx cxr gqz
mbd: hll dtr svf sqk
psl: skg tgx lbr dsr zvq
qxm: skl dlg
rnh: qdl
fmc: rmv qjh
kmd: lsl
lhg: nhm
kxp: xng mpz
qzs: dkp gcf lcm dzj
qvb: xvq
cht: xzz
dsj: fqz hvz jvg
cls: gph psn btg
bln: nms srd
vrk: lgg
vnf: dmg vvc vxb dmq
mpg: mcj nmv rzs zdx lvk
xvn: svg
dtf: khs pmz
fbn: bpf hzs dnl rbl
kfv: mmg lcf qjb
hfl: gzp cgq dnl
mpl: fhl lss
xbt: gdx
mxr: gsk rxg
zvk: lvk ssv fmv bjp
zzt: vxq
njv: vcj rqh dcz
crl: tzj xrs dnq vmb
fmx: mcj vpj
gvs: gmz mcx pks
jhc: qbd
xbz: bgt qkb kdd msn
sml: lzx rzl
dhs: rsx rlj vxg
gsm: lxt
mvh: cht
fbv: fgb tbq pct
rqh: zgb gnp tqj
nbk: qft
zbm: stn dhj rgt hlt hvp
kvl: zgg qbd gjj npb
sfk: qzz mmn qzs scs
cpj: zmh bvv mkj fvx gcq
cxv: shh cnx tpl djm
xrs: xvh stt
tqj: ncm
qmr: vzt ldg
pkv: lmf xmk xcs vmd
fhs: rgn mpc
kqp: cxm
gns: dlg jcr zgg
srm: qsr sgg dsj snx
hsg: cms snf kzs
vfl: mfd psm vpf
bhg: fvx hvg nbh skq
ggj: dzj bcz slc
knd: hkr lmx
pxc: nsk lkp pjf zrj
hgr: zvq xpx mkf
scd: szg hrv kcb plc kzk qcj
jfl: ljl fnq xfn
vtl: lfp vjd kqz xdb
srb: bvz fnq xlc tcp
lxq: bhd xsr
vkp: zvm tbk xtj
bjs: rzl mqk vxq
qlc: xld cch
rjp: nxn bnr lhb tvb npq bvd
bnp: jdh zdz nrf cfk zxk
trf: tqb trd pgd zqd
hnx: qdg vnz lxq kvx
lch: rsg
vbn: jxv
pmb: dnp lch fpv fhp
svq: ktd
pzl: pgc lvk
fjf: mmr qzn zmh tdn
nlm: xrp gdn tjk vmg dnv
rsr: kvf ltj
bst: vcq rht dnp
dcq: dkp vqp
xsp: rpr rjr
jgk: bgm qcs rlf qns
bqd: gnq qzs qqs
lzc: drx vgg hlk
fmp: zrk rvq
rgt: zdj hcf
xlc: znk xgq
plk: vnt qfl fmf rsx gps
vxc: rnk cbn cch kbq
jtv: qrn jxr vjh
lmx: lxk vxq
ffp: kbl lnr ctn xmm rxk
gsn: vrh
vns: csz gkx
qcl: gdh kqp dfd
czb: dzf pct qkb bqd kpc
lzl: nfv lbh zxl
msn: hlv
sdg: gsc dst vpf
phl: fhc ppx zmp
zll: ztf pdz npn phl
lpj: xkg qcb dbx
kvt: pbt
vcg: dlx ppg
xvq: bdd
tjp: pff hpq zqq szf
shm: xgm tch djm
qsp: hzn tmn
dhg: mhx
mmk: mxr nvt jzn
nqp: pbf xdv hkj mcx
fzn: hlj pgd fnb
xgq: gdg
kkx: gbr bvv
jtc: hjg ssr bvv jsj
nvb: ztf
sbz: xtj kxn vmd bgt
nrx: qns
lvh: crj tkq hxr
fkn: xvn xpz nfz
nkr: tcv rdb cnb xbf
dhj: tcj dnd
rcp: hvz rvq gbh
fpd: kzk nxn zqq
cfz: vqr
lnm: hfp dhc ljb
nms: mnf fbr
npf: khs rfk mxr
gnk: zvc pgn
sqv: zsj
znt: khz qxs stm ttz cxl bmk
xxf: ldl gmm
vhg: lsv zzk ncp pfr
kbf: hjg
kbl: zpc bhh
kbn: lnd zrk
fhn: snz rcf ldg
mqg: hlj qsz ldg
vbk: xjc nmb
djv: jdh kbq hll
gcq: lhg kvt zxj lmq
fpv: jjj qrq
nhh: rsm zdr pfr dhn
sts: hlv
gjx: zdg
hbj: czp vmn prk fzn
mqk: bdx
ghh: zsd kbq rgn
tvz: bhd tbr
hpt: hqd hdp jgk bbk dmb
ftg: lns hlt ssr
kcb: fmv
vhs: grj dcx sxx tts
qcp: xrd
dfc: npf qbs hxv
pvc: kll mvh mpc srv jzn
hqt: ddt vns ftt xqq
fvm: rpz mtz nkn nlk
mvv: cmv kmq vvq lsv
zmp: xtx
xcd: cfz lpq lxt
pzs: rmv qsp tmk
snf: qxm rxl
ddt: pct
fct: rql xbt
cdn: njb xpp shm tkc
nxm: szg
fng: dhc trd npq vhr gvs
xdv: qxz
txx: hnd xlc jql blh
mkr: rkl lxt jrb
kld: cxl fph
djm: jvl
nht: dst xrt rvv vtj
nvg: pmv nsn qrz
hkj: drf hrd nps
fzs: czp jtg
png: jcm pxs
mxc: zrk
lpm: vlb hpn
vhq: slc pjf ggb tsh fsz
pdp: rpz qxz bpx
kqk: tzj
ntx: gpt fgj zlq
hrd: zbr
xcr: svg
ppj: rjr qtx krc
qbm: rsp
zpr: xsk zns nst lmf
vld: znk vpx xpz srv xgr png hdg gdg
gmx: kfq
lkz: zkf fhc
sht: jjj dpr
zpt: btg kgs rlx rpd kkr
qsz: kmn gxr sdz
zjp: pbg qrq
tqn: rcs jpm
hvp: npb
bbn: rgn drf csq zmm dlf
nnj: ssv ckc gmh cbt
dzq: svg
sdz: dkk
xfn: mnh
cpq: dxd lgg kmd
kms: zpv sfv ngz
gtj: rmn vsn frj
bmg: jbz
rsk: jzm xls fqs
frt: zmt dfk
rtx: ppg rsb qph dzj
htv: zsj
zpv: xls gnp
pfj: fxr
tgk: tbr rnh xdb tzz ptp ksl hxp
gmz: qjd bfr vpj
zmd: qfn vpx jzm fvf zvc
dlf: mcp
kvf: bkt
kbr: ncm sbt mnh
qxc: xbf vcg bgt
mcx: dqr fxr
vsd: rtz dgl glr gmk dcz
ptf: gqz nbk
qjx: mfv dhk dlx
hsb: dbn rzs gqx dhh
gdr: fqz ndh djv
tjr: qbm vcn
pnp: rxg zqq gbx mtz
tlj: shg vcq cdq
qqs: mmb dnh fhc sfm cpv
fqz: hfp
jvr: cfl xlm vst
cnf: vpb rcb krp srz
hhs: vvq
nfx: rcj xmk
crv: zbl kfb dzq stt
gxn: cfz nsm
rhd: vgg rtz cch
jkc: sqf ltj kpg hlj rds
ztb: xjm trd klt qcl
tkd: nrq blk
zmg: lxq bdx xbt xxv
xhm: cpq mmg xbf
nfn: rnh
fsc: jxr tlx gdh gfm
hxv: zlg qrn
dzv: qlc qdk jnf pqq
qnz: xjc
bbk: nml qxh gdx
vch: zkf nxp vgb
sxj: qrz
xrt: rfb clv fgb
tvb: rfn gjx
xdc: jdh bvd xjm jbf
mtz: txv
dcz: pxl
zlb: dfp xrk fnj
mtt: fvf xfd cbn
rzn: jvr qph mtv
cjl: nnq rpn mcp msl
zqq: pdb
gxt: tmn xnh
nfs: qbc zhv lnr mqg
ngb: pqp qmn stt
rfb: scs
qpl: lcf qft rkk
mkf: snf xxn
hgg: kjl nsg lss kdk
tpl: zzt
tsm: svh ftg knd ddt kjv lbh
vrq: rvq xjm zpk fdk
tcv: cvq xrd vln
xnm: dhh tcz qjd tvb jjp
fgc: lxn nnh
ztv: rsm
qnj: hbk kdd gql fnx
qbt: pbt dnh bvs mlp dfk
snz: xzv
fvg: gsf lkp rcj
pqq: xfn ktx hpd lbn jzj zvp
cxn: mfh plb ghp
vmn: vbn snx gpz
zzz: vfn nsm
mhz: qfl vbj nps hgh
zdj: nkp
qph: fst nqh
bnr: xhn
qxs: zzz clk cch
rcg: vgb
kns: qlc
zvp: rxk kvf
rcn: flh xnc nrf
phh: ztd hlt hbx scs
jql: pjb fck
tqf: dkp cgs tdb
hlv: zxj
pkf: kzs jgh nvb qcs
zbn: mnj
gch: njt gbc jgd rxc khs fkn
dfj: rcs rfb kgp
cmz: lgg gqp dng npn
gnq: mmb lkz
pdc: xdj pct fnx
hlc: ftg pmh rdq kbf mjv
ltn: crx dzj gql
vnd: tfz xsr
krp: jjj vpf
zhv: vqr
jtb: mzb tjk lpz
dbr: gfn lch ldr hvp shg
pkx: gsk ctz rjh dlf
djs: fjq tsf dhj
lrm: dcx xbf
mzh: mxp xtf jvl pmx
lgk: dng qkb skg qft dtc
vxs: rcf mmk xrs mtb
jvn: szv ljb lss szf rsk
kxj: hnd hpc nfd jqk dht
mcj: qmq
zmr: qhn frp
kvx: rmn sts lkj
pjh: zqk nvg xrk pzd
vrr: hhs phh frj
bvz: xtz gdh kzt
jbd: frp lzg sts ntx vqn
lns: vhs cfl
xgm: mfd
zvh: npb bgt zvm
grk: njv dnr dfc
nbn: zpn svh qsj ggb
lxs: fnr fmx gxn
gdh: lnd rnp
qtx: svq rpz
kjx: jcm
zbx: gxj gng bhd cmv
jbf: kgs
zhc: pts vlb bvd
vkv: shm rsm dxd
kvj: dgx dfk jhc
shh: xvb xxn
fxh: lmg cqn
btg: bhb xhn
jbs: ghp dbq kjs dnv
fdk: pdv mvs nhs
pmx: nks
gpz: rnp
mgh: jfc gjp
fpg: gjj zsh frz hkr zth
hmz: qss njr clf
mpt: hdp xzs tsh tzz
gck: kxp rmf zds hpn jdh
nnq: nps fmv
bfs: tsh dst
qns: hhs
hls: fst ssd
lcb: fbr pct zlq
ptm: cht qnz gbh
fph: lbd vrh fgc
pbq: kzj gkn qrq
fml: mlg nnq kmj mmq
xmx: pkk tkc sxq lzl rcj
xkk: nrx rkd hsn qxc sxp
xpx: fhv dgb tqn gld
vzt: pff
nqj: mxc mtz hnh vcn rfn gnk
hzq: czm qxz ltj
drc: pgl jtv gqx
xvb: vqp crc
hqq: zgg
qmn: kqk pqp zbl
smt: lmv xcx chk tth
fbt: mtv lbr phq lvh
vcj: cqn rmv
dkr: fnq hbr rlx
mdq: frp hsj gcf rlz
hpq: mpc
vnm: rxg kmn lmg nsg
tvx: hrq cfk drx
qbb: njt bmb ktd kbl
rjr: qnz
zxl: cmf
rtz: xpz cbn
qhs: hxp dnd rht xnq
srd: ggb xjv vxb qpl crc
smk: cpv vff qcg
zns: ccd xsr kjs krv
qjd: rpr
zfv: tkc zpq
gsk: xvn
npb: xgm
csg: gxn gdh ddf gxk hpq
vhc: nzj xpp czg nfx mkc
zkh: kgp phq hkm
xmz: ztv sff
jrm: jcr vtj lxb
qjb: skl nrq sts lfs
jrb: gxt qfn vtz
kmb: bmb dfd
xdb: nxp mfh
lnv: rfr
lqs: lcm mxp kkx xsk
bvd: zgb
vzg: gns zzt qdl tsf lrm
hcv: bqf zvm
nsh: hvg gsf zvm nds
ddf: vqt hrq
dvh: nbk qcb lln vmd xgs vsn
dfz: pqp xhn xps
zdp: snz
chk: ztf gmg
vqr: rxg
sxz: kld fhl bvd zhv ljb
klc: zsz qbt xjx
gbh: vjh
lgn: qdg dfj vxq sbd
xhp: nvb mkc
rgp: xfd rpd kll rfn
rlh: dfd xcd hld tsv
rsg: fnx mnj
xkg: pck mzd tts
jcm: fnb
fvx: qhf vch
gng: ppg qns lpz djn
spp: rfr
bgm: vsn
qdb: dht nsl ttv
lcf: bdd nsn
pzd: fst dqs vbp qzs
jjb: stm cht
tbk: xbf
crj: chf tlj
dzm: gmx rkd kkf rsc
lgm: stn lzx jcj nzj
rqr: vpj kmr fmp qsg
vtj: htv dpr
zjl: rht
sxq: vgb dfj rcj
cps: tlj grj xrp zlb
cqn: nsg
bmq: rhd vzt zqd rjb zsd snx
rmv: gdg
hcf: bnl qvb hjg fhd mtv
qlj: lzx vxb kvx ztd
pcf: lnd
qhd: mzh fhc dtc kzj
klp: gdg qdk cqg
gzs: bxp fpx cpv jbz
cng: xzz hfb zmm
bvs: nqh
rsc: plb lgg
szf: ksf
kjl: lmg
crx: blk hls lcf
sbn: mfn
kjv: pfl mzq tqf
rjh: qbm
rmn: jvl
msj: rkd nst
vdt: lbd hll fpd vkj
jfp: clf lch vbp
rhs: gmg lmf zdr
nhc: zcg zmr nst zfv
vpj: vgg
tzd: rkd
xlt: dfd qxz
tpp: dbx vvq krp
ghp: qrq sfm
bns: tqn svp nks nzj
gxk: qjh clh nhs
tdn: dlx rsm
mdh: fvg jrm fct vcq
jhq: mzb dnp fct ddt xsm tvz
dgf: xzs hlv jbz vqp phh
lkp: cmf
dlx: xvq
ldr: hxr fsg xtx
fsg: kvn
gdx: xvq
qjk: zpv sns rpr
prp: hpf
fhv: zht ccd
ngz: hpc
qdd: zds cbg dhg qsr vfn
xcx: cnb lbj lzg
gkm: prg zjp jtb rsm bvx lls xcb
nfg: xxv rht kvn hmj
ghd: rgn qnx
nfb: ckk kcb mtt jbn szf
dbn: mnh rfk
qln: fph flj hss
dnv: xtx nvg
bvv: bdx
zpk: hgn rlx hlk lzc
svm: frt tsm dsr qbt
vdh: nzj zpn mmn xxv
gkt: gjx xlt xxf khj vjh
